Ms^Xm, Ms^Xm, Ms^Xm, Ms^Xm, Ms^Xm, Ms^Xm, Mm, Mm^Xm, Mm^Xm, Mm^Xm, Mm, Mm, Mm, Mm, Mm, Mm, Mm, Mm, Mm, Mm, Mm, Mm, Mm, Mm, Hh, Hh, Hh, Gs^Fp, Gs^Fp, Gs^Fp, Gs^Fp, Gs^Fp, Gs^Fp, Gs^Fp, Gs^Fp, Gs^Fp, Gs^Fp, Gs^Fp, Gs^Fp, Gs^Fp, Gs^Fp, Gs^Fp, Gs^Fp, Gs^Fp, Gg, Gs^Fp, Gs^Fp
Ms^Xm, Ms^Xm, Ms^Xm, Mm, Ms^Xm, Mm, Ms^Xm, Mm, Mm, Mm, Mm, Mm, Mm, Mm, Mm, Mm, Mm, Mm, Mm, Mm, Mm, Mm, Mm, Mm, Mm, Hh, Hh, Gs^Fp, Hh, Gs^Fp, Hh, Gs^Fp, Gs^Fp, Gs^Fp, Gs^Fp, Gs^Fp, Gs^Fp, Gs^Fp, Gs^Fp, Gs^Fp, Gg, Gs^Fp, Gs^Fp, Gs^Fp, Gs^Fp, Gs^Fp, Gs^Fp
Ms^Xm, Mm, Ms^Xm, Mm, Mm, Ms^Xm, Mm, Mm, Ms^Xm, Mm, Mm, Hh, Hh, Hh, Hh, Mm, Hh, Hh, Hh, Mm, Mm, Mm, Mm, Mm, Mm, Mm, Mm, Hh, Hh, Gs^Fp, Mm, Gs^Fp, Gs^Fp, Gs^Fp, Gs^Fp, Gs^Fp, Gs^Fp, Gs^Fp, Gs^Fp, Gs^Fp, Gs^Fp, Gs^Fp, Gs^Fp, Gs^Fp, Gg^Fet, Gs^Fp, Gs^Fp
Ms^Xm, Mm, Mm, Ms^Xm, Mm, Ms^Xm, Ms^Xm, Ms^Xm, Ms^Xm, Mm, Aa^Fpa, Hh, Hh, Hh, Hh, Hh, Gs^Fp, Hh, Hh, Hh, Mm, Mm, Mm, Mm, Mm, Ms^Xm, Ms^Xm, Mm, Ms^Xm, Mm, Mm, Mm, Mm, Gs^Fp, Gs^Fp, Gs^Fp, Gs^Fp, Gg^Fet, Gg, Gg, Gg^Ve, Gs^Fp, Gs^Fp, Gs^Fp, Gs^Fp, Gs^Fp, Gs^Fp
Ms^Xm, Ms^Xm, Mm, Mm, Ms^Xm, Ms^Xm, Ms^Xm, Ms^Xm, Mm, Mm, Aa^Fpa, Gs^Fp, Hh, Hh, Gs^Fp, Gs^Fp, Gs^Fp, Hh, Hh, Hh, Hh, Hh, Hh, Mm, Mm, Ms^Xm, Ms, Mm, Mm, Mm, Ms^Xm, Mm, Mm, Mm, Mm, Gs^Fp, Gs^Fp, Gg, Gs^Fp, Gg, Gs^Fp, Gs^Fp, Gs^Fp, Gs^Fp, Gs^Fp, Gs^Fp, Gs^Fp
Mm, Ms^Xm, Ms, Ms^Xm, Ms, Ms, Ms, Mm, Aa^Fpa, Aa^Fpa, Aa^Fpa, Aa^Fpa, Gs^Fp, Hh, Gs^Fp, Gg, Gs^Fp, Hh, Hh, Hh, Gs^Fp, Hh, Hh, Ha, Hh, Mm, Mm, Ms, Ms, Ms^Xm, Ms^Xm, Ms^Xm, Ms^Xm, Mm, Mm, Mm, Mm, Gs^Fp, Gs^Fp, Gs^Fp, Gg, Gs^Fp, Gs^Fp, Gs^Fp, Gs^Fp, Gs^Fp, Gs^Fp
Mm, Mm, Mm, Ms, Ms, Aa^Fpa, Aa^Fpa, Aa^Fpa, Gs^Fp, Aa^Fpa, Aa^Fpa, Aa^Fpa, Gs^Fp, Aa^Fpa, Gs^Fp, Gs^Fp, Hh, Hh, Hh, Gs^Fp, Hh, Gs^Fp, Hh, Hh, Gs^Fp, Hh, Ha, Ha, Ha, Ms, Ms, Ms^Xm, Ms^Xm, Ms^Xm, Mm, Mm, Mm, Gs^Fp, Gs^Fp, Gs^Fp, Gg, Gs^Fp, Gs^Fp, Gs^Fp, Gg^Ve, Gs^Fp, Gs^Fp
Mm, Mm, Mm, Mm, Mm, Gs^Fp, Aa^Fpa, Gs^Fp, Hh, Gs^Fp, Gs^Fp, Gs^Fp, Gs^Fp, Gs^Fp, Gs^Fp, Gs^Vh, Hh, Hh, Hh, Hh, Hh, Hh, Gs^Fp, Gs^Fp, Gs^Fp, Gs^Fp, Gs^Fp, Ha, Ha, Ha, Ha, Mm, Mm, Ms^Xm, Ms^Xm, Mm, Mm, Mm, Hh, Gs^Fp, Gg, Gg, Gs^Fp, Gs^Fp, Gs^Fp, Gs^Fp, Gs^Fp
Wo, Wo, Wo, Wo, Wo, Hh, Aa^Fpa, Aa^Fpa, Hh, Gs^Fp, Gs^Fp, Gs^Gvs, Gs^Fp, Re^Gvs, Re^Gvs, Gs^Fp, Gs^Fp, Hh, Gs^Fp, Hh, Hh, Gs^Fp, Gs^Fp, Gs^Fp, Gg^Efm, Gs^Fp, Gs^Fp, Gg^Fet, Gg^Ve, Hh, Ha, Mm, Ha, Mm, Mm, Ms^Xm, Mm, Mm, Mm, Hh, Mm, Gs^Fp, Gs^Fp, Gs^Fp, Gs^Fp, Gs^Fp, Gs^Fp
Ms^Xm, Mm, Ms^Xm, Mm, Mm, Wo, Wo, Gs^Fp, Wo, Gs^Fp, Gs^Fp, Gs^Vh, Gs^Fp, Gs^Fp, Re^Gvs, Gs^Fp, Gs^Fp, Gg, Gs^Fp, Gs^Fp, Hh, Gs^Fp, Gs^Fp, Gg^Efm, Gs^Fp, Gs^Fp, Gs^Fp, Gs^Fp, Gs^Fp, Gs^Fp, Gs^Fp, Ha, Ha, Mm, Mm, Mm, Mm, Mm, Mm, Mm, Hh, Gs^Fp, Gs^Fp, Gs^Fp, Gs^Fp, Gs^Fp, Gs^Fp
Ms^Xm, Mm, Ms^Xm, Ms^Xm, Ms^Xm, Mm, Hh^Vhh, Wo, Gs^Fp, Wo, Wo, Gs^Fp, Gs^Fp, Gs^Fp, Re^Gvs, Gs^Fp, Gg, Gg, Gg, Gs^Fp, Gs^Fp, Gs^Fp, Gs^Ve, Re^Gvs, Gs^Fp, Gs^Fp, Gs^Fp, Gs^Fp, Gs^Fp, Gs^Fp, Gs^Fp, Gs^Fp, Gs^Fp, Ha, Ha, Mm, Ha, Mm, Mm, Ha, Ha, Gs^Fp, Mm, Gs^Fp, Gg^Fet, Gs^Fp, Gs^Fp
Mm, Ms^Xm, Ms^Xm, Ms^Xm, Mm, Mm, Ha, Mm, Mm, Gs^Fp, Gs^Fp, Wo, Wo, Gs^Fp, Gs^Fp, Gs^Fp, Gs^Fp, Gg^Fet, Gs^Fp, Gg, Gg, Gs^Fp, Gs^Fp, Re^Gvs, Gg^Efm, Gg^Efm, Gs^Fp, Gs^Fp, Gs^Fp, Gg, Gs^Fp, Gs^Fp, Gs^Fp, Gg^Fet, Gs^Fp, Hh, Hh, Ha, Ha, Ha, Ha, Mm, Mm, Gs^Fp, Gs^Fp, Gs^Fp, Gs^Fp
Mm, Mm, Mm, Mm, Mm, Mm, Ha, Mm, Mm, Mm, Mm, Hh, Hh, Wo, Wo^Bw/, Gs^Fp, Gs^Fp, Gs^Fp, Gs^Fp, Gs^Fp, Gs^Fp, Gg, Gs^Fp, Gs^Fp, Gs^Fp, Gg^Efm, Gs^Fp, Gs^Fp, Gg, Gg, Gg, Gs^Fp, Gs^Fp, Gs^Fp, Gs^Fp, Hh, Gs^Fp, Hh, Hh, Mm, Mm, Mm, Mm, Mm, Gs^Fp, Gs^Fp, Gs^Fp
Ms^Xm, Mm, Mm, Mm, Ms, Mm, Ha, Mm, Hh, Mm, Gs^Fp, Mm, Ch, Ch, Ch, Wo, Gs^Fp, Gs^Fp, Gs^Fp, Gg^Fet, Gs^Fp, Gs^Fp, Gs^Fp, Gg^Efm, Gg^Efm, Gs^Fp, Gs^Fp, Gs^Fp, Gs^Fp, Gs^Fp, Gs^Fp, Gs^Fp, Gs^Fp, Gs^Fp, Gs^Fp, Gs^Fp, Gs^Fp, Hh, Hh, Hh, Mm, Mm, Mm, Mm, Mm, Gs^Fp, Gs^Fp
Re, Re, Re, Re, Re, Ha, Hh, Hh, Re, Hh, Gs^Fp, Gg^Efm, Ch, 2 Kh, Ch, Wo, Wo, Gs^Fp, Ww, Gs^Fp, Gs^Fp, Gs^Fp, Gg^Fet, Gs^Fp, Gs^Fp, Gs^Fp, Gs^Fp, Gs^Fp, Gs^Fp, Gs^Fp, Gg^Efm, Gg^Fet, Gs^Ve, Gs^Fp, Re^Gvs, Gs^Fp, Gs^Fp, Gs^Fp, Hh, Hh, Mm, Mm, Mm, Mm, Mm, Gg^Fet, Gs^Fp
Mm, Mm, Ms^Xm, Mm, Ms, Re, Re, Re, Ce, Re, Re, Gg^Efm, Gg^Efm, Ch, Gg^Efm, Gs^Fp, Gs^Fp, Ww, Ww, Ww, Ww, Gs^Fp, Gs^Fp, Gs^Fp, Gs^Fp, Gg^Efm, Re^Gvs, Gs^Fp, Gs^Fp, Gs^Fp, Gg^Efm, Gs^Fp, Gs^Fp, Re^Gvs, Gs^Fp, Gs^Fp, Hh, Hh, Mm, Mm, Mm, Mm, Mm, Mm, Mm, Mm, Gs^Fp
Mm, Ms^Xm, Ms^Xm, Ms^Xm, Ms, Ha, Hh, Ce, 1 Ke, Ce, Gs^Fp, Re, Re, Gg^Efm, Gs^Fp, Gs^Fp, Gs^Fp, Gs^Fp, Ww, Ww, Gs^Fp, Ww, Gs^Fp, Gs^Fp, Gs^Fp, Gg, Re^Gvs, Re^Gvs, Gs^Fp, Gg^Efm, Gs^Fp, Gs^Fp, Gs^Fp, Re^Gvs, Gs^Fp, Gs^Fp, Hh, Mm, Mm, Mm, Mm, Mm, Mm, Mm, Mm, Gs^Fp, Gs^Fp
Mm, Ms^Xm, Ms^Xm, Ms^Xm, Mm, Ha, Hh, Ce, Ce, Ce, Hh, Gs^Fp, Gs^Fp, Re, Re, Re, Re, Re, Re, Ww, Ww, Ww, Gs^Fp, Gs^Fp, Gg, Gs^Vh, Re^Gvs, Re^Gvs, Gs^Fp, Gs^Fp, Gs^Fp, Gs^Fp, Gs^Fp, Gs^Fp, Gs^Fp, Gs^Fp, Hh, Mm, Mm, Mm, Mm, Mm, Mm, Mm, Mm, Gs^Fp, Gs^Fp
Mm, Mm, Ms^Xm, Mm, Mm, Mm, Mm, Hh, Hh, Hh, Hh, Hh, Hh, Gs^Fp, Gs^Fp, Gs^Fp, Gs^Fp, Gs^Fp, Gg, Re, Re, Ww, Ww, Gs^Fp, Gg, Gg, Re^Gvs, Gs^Fp, Gs^Fp, Gs^Fp, Gg, Gs^Fp, Gs^Fp, Gg, Gs^Fp, Hh, Hh, Mm, Mm, Mm, Mm, Mm, Mm, Mm, Mm, Gs^Fp, Gs^Fp
Mm, Ms^Xm, Ms^Xm, Ms^Xm, Mm, Mm, Mm, Mm, Mm, Mm, Mm, Hh, Mm, Hh, Hh, Gs^Fp, Gs^Fp, Gs^Fp, Gs^Fp, Gs^Fp, Gg^Vh, Re, Re, Ww, Ww, Gs^Fp, Gs^Fp, Gs^Fp, Gs^Fp, Gs^Fp, Gs^Fp, Gg, Gg^Fet, Gs^Fp, Gs^Fp, Hh, Hh, Mm, Ce, Ce, Ce, Mm, Mm, Mm, Mm, Mm, Mm
Mm, Ms^Xm, Ms^Xm, Ms^Xm, Ms^Xm, Mm, Mm, Mm, Mm, Mm, Mm, Mm, Mm, Mm, Hh^Vhh, Hh, Hh, Gs^Fp, Hh, Gs^Fp, Re^Gvs, Re^Gvs, Re^Gvs, Re, Re, Ww, Ww, Gs^Fp, Ww, Gs^Fp, Gs^Fp, Gs^Fp, Gg^Ve, Gg, Gs^Fp, Hh, Hh, Mm, Ce, 3 Ke, Ce, Ce, Mm, Mm, Mm, Mm, Mm
Ms^Xm, Mm, Ms^Xm, Ms^Xm, Ms^Xm, Mm, Mm, Ha, Ha, Mm, Mm, Mm, Mm, Mm, Mm, Mm, Mm, Hh, Hh, Hh, Gs^Fp, Gs^Fp, Gs^Fp, Re^Gvs, Gs^Fp, Re, Re, Ww, Re, Ww, Wwf, Re^Gvs, Re^Gvs, Gs^Fp, Gs^Fp, Gs^Fp, Hh, Mm, Mm, Ce, Mm, Mm, Hh, Hh, Hh, Mm^Vhh, Hh
Ms^Xm, Ms^Xm, Ms^Xm, Mm, Mm, Mm, Ha, Ha^Vhha, Hh, Ha, Ha, Hh, Hh, Mm, Gs^Fp, Mm, Gs^Fp, Mm, Mm, Hh, Hh, Gs^Fp, Gs^Fp, Gs^Fp, Gs^Fp, Gs^Fp, Mm, Re, Mm, Re, Re, Ww, Ww, Gs^Fp, Gs^Fp, Gs^Fp, Gs^Fp, Hh, Hh, Mm, Hh, Hh, Hh, Hh, Gs^Fp, Hh, Gs^Fp
Mm, Ms^Xm, Ms^Xm, Ms^Xm, Mm, Mm, Ha, Ha, Aa^Fpa, Ha, Ha, Hh, Hh, Hh, Gs^Fp, Gs^Fp, Gg^Efm, Gs^Fp, Gg^Efm, Mm, Hh, Hh, Hh^Vhh, Gs^Fp, Gg^Efm, Gg^Efm, Mm, Mm, Mm, Hh, Hh, Re, Re, Ww, Ww, Ww, Ww, Hh, Ww, Hh, Ww, Ww, Ww, Gs^Fp, Gs^Fp, Gs^Fp, Gs^Fp
Mm, Ms^Xm, Ms^Xm, Mm, Mm, Mm, Ha, Hh, Aa^Fpa, Aa^Fpa, Gs^Fp, Gs^Fp, Gs^Fp, Gs^Fp, Gs^Fp, Gs^Fp, Gs^Fp, Gg^Efm, Gs^Fp, Hh, Hh, Hh, Mm, Hh, Hh, Gs^Fp, Mm, Mm, Mm, Mm, Mm, Hh^Vhh, Hh, Re, Re, Re, Re, Ww, Hh, Ww, Hh, Hh, Hh, Ww, Ww, Gs^Fp, Gs^Fp
Mm, Mm, Mm, Mm, Mm, Mm, Ha, Hh, Aa^Fpa, Aa^Fpa, Gg^Efm, Gs^Fp, Gg^Fet, Gs^Fp, Gs^Fp, Gs^Fp, Gs^Fp, Gs^Fp, Re^Gvs, Re^Gvs, Gs^Fp, Hh, Hh, Mm, Mm, Hh, Hh, Mm, Mm, Mm, Mm, Hh, Hh, Hh, Hh, Hh, Hh, Re, Re, Hh, Re, Hh, Hh, Hh, Hh, Ww, Ww
Ms^Xm, Mm, Ms^Xm, Mm, Mm, Mm, Mm, Hh, Hh, Aa^Fpa, Hh, Gs^Fp, Gs^Ve, Gs^Fp, Gs^Fp, Re^Gvs, Re^Gvs, Re^Gvs, Re^Gvs, Re^Gvs, Gs^Fp, Gs^Fp, Hh, Mm, Mm, Mm, Hh, Hh, Hh, Mm, Gs^Fp, Mm, Mm, Hh, Mm, Hh, Mm, Hh, Hh^Vhh, Re, Gs^Fp, Re, Re, Hh, Re, Re, Re
Ms^Xm, Ms^Xm, Mm, Mm, Mm, Mm, Mm, Mm, Mm, Hh, Hh, Hh, Gs^Fp, Gg^Efm, Gs^Fp, Gs^Fp, Gs^Fp, Gs^Fp, Gs^Fp, Gs^Vh, Gs^Fp, Gs^Fp, Hh, Hh, Hh, Hh, Gs^Fp, Hh, Mm, Gs^Fp, Gs^Fp, Gs^Fp, Gs^Fp, Mm, Mm, Mm, Mm, Mm, Hh, Hh, Gs^Fp, Gs^Fp, Gs^Fp, Re, Gs^Fp, Gs^Fp, Gs^Fp
Ms^Xm, Ms^Xm, Mm, Mm, Mm, Mm, Mm, Mm, Gs^Fp, Mm, Hh, Hh, Mm, Gs^Fp, Gs^Fp, Gs^Fp, Gs^Fp, Gs^Fp, Gs^Fp, Gs^Fp, Gg^Fet, Gs^Fp, Hh, Gs^Fp, Gs^Fp, Gs^Fp, Gs^Fp, Mm, Mm, Gs^Fp, Mm, Gs^Fp, Gs^Fp, Gs^Fp, Gg, Gs^Fp, Gs^Fp, Gs^Fp, Hh, Hh, Hh, Gs^Fp, Hh, Gs^Fp, Gg, Gg, Gg
Ms^Xm, Ms^Xm, Ms^Xm, Mm, Mm, Mm, Mm, Mm, Mm, Gs^Fp, Gs^Fp, Gs^Fp, Mm, Mm, Gs^Fp, Gs^Fp, Gg^Fet, Gs^Fp, Gs^Fp, Gs^Fp, Gs^Fp, Gs^Fp, Hh, Hh, Gg^Efm, Gg^Efm, Gs^Fp, Mm, Gs^Fp, Mm, Mm, Mm, Hh, Gg, Gs^Fp, Gs^Fp, Gs^Fp, Gs^Fp, Gs^Fp, Gs^Fp, Gs^Fp, Hh, Gs^Fp, Hh, Gs^Fp, Gs^Fp, Gs^Fp
Ms^Xm, Ms^Xm, Ms^Xm, Mm, Mm, Mm, Ha, Mm, Mm, Gs^Fp, Mm, Gs^Fp, Mm, Mm, Mm, Gs^Fp, Gs^Fp, Gs^Fp, Hh, Hh, Hh, Hh, Hh, Gs^Fp, Gs^Fp, Gg^Efm, Gs^Fp, Gs^Fp, Gs^Fp, Gg^Efm, Gs^Fp, Hh, Hh, Hh, Hh, Gs^Fp, Gs^Fp, Gs^Fp, Gs^Fp, Gs^Fp, Gs^Fp, Gs^Fp, Gs^Fp, Gs^Ve, Gs^Fp, Gs^Fp, Gs^Fp
Ms^Xm, Ms^Xm, Ms^Xm, Mm, Mm, Mm, Ha, Hh, Hh, Hh, Hh, Mm, Mm, Mm, Mm, Mm, Gs^Fp, Gg^Efm, Mm, Hh, Hh, Hh, Mm, Hh, Hh, Gs^Fp, Gs^Fp, Gs^Fp, Hh, Gs^Fp, Hh, Hh, Gs^Fp, Gs^Fp, Gs^Fp, Hh, Hh, Gs^Fp, Hh, Gs^Fp, Gs^Fp, Gs^Fp, Gs^Fp, Gg, Gg, Gs^Fp, Gs^Fp
Ms^Xm, Ms^Xm, Mm, Mm, Mm, Mm, Ha, Gs^Fp, Hh, Hh, Hh, Hh, Hh, Hh, Mm, Mm, Mm, Mm, Mm^Vhh, Mm, Mm, Mm, Hh, Mm, Mm, Hh, Hh, Hh, Hh, Hh, Hh, Gs^Fp, Gs^Fp, Gs^Fp, Gs^Fp, Gs^Fp, Gs^Fp, Hh, Gs^Fp, Hh, Hh, Gs^Fp, Gs^Fp, Gs^Fp, Gg, Gs^Fp, Gs^Fp
Ms^Xm, Ms^Xm, Mm, Mm, Mm, Mm, Mm, Hh, Gs^Fp, Gs^Fp, Gs^Fp, Gs^Fp, Gg, Gs^Fp, Gs^Fp, Mm, Mm, Mm, Mm, Mm, Mm, Mm, Hh, Hh, Hh, Mm, Hh, Hh, Gs^Fp, Gs^Fp, Gs^Fp, Gs^Fp, Gs^Fp, Gs^Fp, Gs^Fp, Gs^Fp, Gs^Fp, Gs^Fp, Gs^Fp, Gs^Fp, Gs^Fp, Gs^Fp, Gs^Fp, Gs^Fp, Gs^Fp, Gs^Fp, Gs^Fp
Ms^Xm, Ms^Xm, Ms^Xm, Mm, Mm, Mm, Mm, Ha, Gs^Fp, Gs^Fp, Gs^Fp, Gs^Fp, Gg, Gs^Fp, Gs^Fp, Gs^Fp, Gs^Fp, Gs^Fp, Gs^Fp, Mm, Gg, Mm, Mm, Hh, Mm, Hh, Hh, Gs^Fp, Gs^Fp, Gs^Ve, Gg, Gg, Gs^Fp, Gs^Fp, Gs^Fp, Gs^Fp, Gs^Fp, Gs^Fp, Gs^Ve, Gs^Fp, Gs^Fp, Gs^Fp, Gs^Fp, Gs^Fp, Gg, Gg, Gs^Fp
Ms^Xm, Ms^Xm, Ms^Xm, Mm, Ms^Xm, Mm, Mm, Mm, Ms^Xm, Gg^Fet, Gs^Fp, Gs^Fp, Gs^Fp, Gs^Fp, Gs^Fp, Gs^Fp, Gs^Fp, Gg^Fet, Gs^Fp, Gs^Fp, Gg, Gs^Fp, Gs^Fp, Mm, Mm, Hh, Hh, Gs^Fp, Gs^Fp, Gg, Gs^Fp, Gs^Fp, Gs^Fp, Gs^Fp, Gs^Fp, Gs^Fp, Gs^Fp, Gs^Fp, Gs^Fp, Gs^Fp, Gs^Fp, Gs^Fp, Gs^Fp, Gs^Fp, Gs^Fp, Gs^Fp, Gs^Fp
Ms^Xm, Ms^Xm, Ms^Xm, Ms^Xm, Ms^Xm, Ms^Xm, Ms^Xm, Ms^Xm, Gs^Fp, Gs^Fp, Gs^Fp, Gs^Fp, Gs^Fp, Gs^Fp, Gs^Fp, Gs^Fp, Gs^Fp, Gs^Fp, Gs^Fp, Gs^Fp, Gs^Fp, Gs^Fp, Gs^Fp, Mm, Gs^Fp, Gs^Fp, Gs^Fp, Gs^Fp, Gs^Fp, Gs^Fp, Gs^Fp, Gs^Fp, Gs^Fp, Gs^Fp, Gs^Fp, Gs^Fp, Gs^Fp, Gs^Fp, Gs^Fp, Gs^Fp, Gs^Fp, Gs^Fp, Gs^Fp, Gs^Fp, Gs^Fp, Gs^Fp, Gs^Fp
